+--+--+--+--+--+--+--+--+--+--+--+--+--+--+--+
|              |     |     |           |     |
+  +  +--+--+  +  +  +  +  +--+  +--+  +  +  +
|  |        |     |  |  |  |     |     |  |  |
+  +--+--+  +--+--+  +  +  +  +--+--+  +  +  +
|     |  |  |     |     |     |     |     |  |
+--+  +  +  +  +  +  +--+--+--+  +  +--+--+--+
|  |  |  |  |  |  |  |        |  |           |
+  +  +  +  +  +  +  +  +--+  +  +--+--+--+  +
|  |     |  |  |  |  |  |     |  |     |  |  |
+  +--+  +  +--+  +  +  +  +--+  +  +  +  +  +
|        |     |     |  |        |  |     |  |
+--+--+--+--+  +  +--+  +--+--+--+  +--+--+  +
|              |     |        |     |     |  |
+  +--+--+--+--+--+  +--+--+  +  +  +  +--+  +
|  |              |        |     |  |  |     |
+  +--+--+--+  +--+--+--+  +--+--+  +  +  +--+
|           |     |     |        |  |     |  |
+--+--+--+  +--+  +  +  +--+--+  +  +--+--+  +
|        |     |     |     |     |     |     |
+  +--+  +--+  +  +--+--+  +  +--+--+  +  +  +
|  |           |  |     |           |  |  |  |
+  +--+--+--+--+  +  +--+--+--+--+  +  +  +  +
|  |        |        |           |  |  |  |  |
+  +  +--+  +--+--+--+  +--+--+  +--+  +--+  +
|  |     |  |        |  |     |  |     |     |
+  +--+  +  +  +--+  +  +  +--+  +  +--+  +  +
|  |     |  |  |  |  |  |     |  |     |  |  |
+  +  +--+  +  +  +  +  +--+  +  +--+  +  +  +
|        |        |           |           |  |
+--+--+--+--+--+--+--+--+--+--+--+--+--+--+--+

