+--+--+--+--+--+--+--+--+--+--+--+--+--+--+--+
|           |     |     |              |     |
+  +--+--+  +  +  +  +  +  +--+--+  +  +--+  +
|        |  |  |     |     |        |     |  |
+--+--+  +--+  +--+--+--+--+  +--+--+--+  +  +
|     |  |     |     |        |           |  |
+  +  +  +  +--+  +  +  +--+--+--+--+  +--+  +
|  |     |        |  |              |        |
+  +--+--+--+  +--+--+--+--+  +--+  +--+--+  +
|              |           |  |     |     |  |
+  +--+--+--+--+  +--+--+  +  +  +--+--+  +  +
|     |     |  |     |     |  |  |        |  |
+--+  +  +  +  +--+  +--+  +--+  +  +  +--+  +
|     |  |        |     |        |  |  |     |
+  +--+  +--+--+--+--+  +--+--+--+  +  +  +--+
|  |     |           |  |        |  |  |  |  |
+  +--+  +  +--+--+  +  +  +--+  +  +--+  +  +
|        |  |     |  |  |     |     |     |  |
+--+--+--+--+  +--+  +  +  +  +--+--+  +--+  +
|              |     |  |  |           |     |
+  +--+  +--+--+  +--+  +  +--+--+--+--+--+  +
|     |        |     |  |              |     |
+--+  +--+--+  +--+  +  +--+--+--+--+  +  +  +
|  |     |  |     |  |  |  |        |     |  |
+  +--+  +  +--+  +  +  +  +  +--+  +--+--+  +
|        |     |     |  |     |  |        |  |
+  +--+--+  +  +--+--+  +  +--+  +--+  +--+  +
|  |     |  |           |     |     |  |     |
+  +  +  +  +--+--+--+--+--+  +  +  +  +  +--+
|     |     |                    |  |        |
+--+--+--+--+--+--+--+--+--+--+--+--+--+--+--+

