+--+--+--+--+--+--+--+--+--+--+--+--+--+--+--+
|  |        |                          |     |
+  +  +--+  +  +--+--+--+--+--+--+--+  +--+  +
|  |  |  |  |     |        |        |        |
+  +  +  +  +--+  +  +--+  +--+  +  +--+--+  +
|        |     |  |  |  |     |  |           |
+  +--+--+--+  +  +  +  +--+  +  +--+--+--+--+
|  |  |        |  |        |  |  |  |        |
+  +  +  +--+--+  +--+--+  +  +  +  +  +--+  +
|  |  |  |                 |  |  |     |     |
+  +  +  +--+  +--+--+--+--+  +  +--+--+  +  +
|  |  |     |     |        |  |           |  |
+  +  +--+  +--+--+  +--+  +  +--+--+--+--+  +
|  |     |           |     |  |     |        |
+  +--+  +  +--+--+--+  +--+  +  +  +  +--+--+
|     |  |     |        |        |  |        |
+  +--+  +  +--+  +--+--+--+--+  +  +--+--+  +
|  |     |  |     |           |  |     |     |
+  +  +--+  +  +--+  +--+--+  +  +--+  +--+--+
|  |     |  |  |  |     |     |     |        |
+  +--+  +--+  +  +  +  +--+  +--+  +--+--+  +
|     |  |     |     |     |     |  |        |
+--+  +  +  +--+--+--+--+  +--+  +  +  +--+  +
|     |     |           |  |  |  |  |  |     |
+  +--+--+--+  +--+--+  +  +  +  +--+  +  +--+
|  |           |     |     |     |     |  |  |
+  +--+  +--+--+  +  +--+--+  +--+  +--+  +  +
|     |  |  |     |  |     |  |     |  |     |
+--+  +  +  +  +  +--+  +  +  +--+  +  +--+  +
|        |     |        |           |        |
+--+--+--+--+--+--+--+--+--+--+--+--+--+--+--+

