+--+--+--+--+--+--+--+--+--+--+--+--+--+--+--+
|     |        |        |           |        |
+  +  +  +--+--+  +  +--+  +--+  +  +--+  +  +
|  |     |        |     |  |     |        |  |
+  +--+--+  +--+--+--+  +  +  +--+--+--+--+--+
|              |        |  |        |        |
+--+--+--+--+  +  +--+--+  +--+--+  +  +--+  +
|        |     |                 |     |     |
+  +--+  +--+--+--+--+--+--+--+--+  +--+  +  +
|  |        |           |        |  |     |  |
+  +--+--+  +  +--+--+  +  +--+  +  +  +--+  +
|        |     |     |     |     |  |  |     |
+--+--+  +--+--+  +--+--+--+  +--+--+  +  +--+
|        |                    |     |  |  |  |
+  +--+--+  +--+--+--+--+--+--+  +  +  +  +  +
|     |     |        |           |     |     |
+--+  +--+  +--+  +  +--+--+  +--+--+--+--+  +
|  |     |        |  |     |     |        |  |
+  +  +  +--+--+--+  +  +  +  +  +  +--+--+  +
|  |  |     |     |     |  |  |  |        |  |
+  +--+--+  +  +  +--+--+  +  +  +--+--+  +  +
|     |     |  |     |     |  |        |     |
+--+  +  +--+  +--+--+  +--+--+  +--+  +--+--+
|  |  |  |  |     |     |     |     |        |
+  +  +  +  +  +  +  +--+  +  +--+--+--+  +  +
|  |     |  |  |     |     |     |     |  |  |
+  +--+--+  +  +--+--+  +--+--+  +  +  +--+  +
|     |        |        |     |  |  |     |  |
+  +--+  +--+--+--+  +--+  +  +  +  +--+  +  +
|                    |     |        |        |
+--+--+--+--+--+--+--+--+--+--+--+--+--+--+--+

