+--+--+--+--+--+--+--+--+--+--+--+--+--+--+--+
|           |                 |     |        |
+  +  +--+  +--+  +--+--+  +  +  +  +  +  +--+
|  |  |  |     |  |  |     |     |  |  |     |
+--+  +  +--+  +  +  +  +--+--+--+  +--+--+  +
|     |        |     |     |     |     |     |
+  +--+--+--+  +--+  +--+  +  +--+--+  +  +--+
|           |     |  |     |        |  |     |
+  +--+--+  +--+  +  +  +--+  +--+  +  +--+  +
|  |        |  |  |  |     |  |     |        |
+  +  +--+--+  +  +--+--+  +  +  +  +--+--+  +
|  |  |           |        |  |  |     |     |
+  +  +  +--+--+--+  +--+--+  +  +  +--+  +--+
|  |  |           |     |     |  |  |     |  |
+  +  +--+--+--+  +--+  +  +--+  +--+  +--+  +
|  |  |        |  |     |     |  |     |     |
+  +  +  +  +--+  +  +--+--+  +  +  +--+--+  +
|  |  |  |  |     |     |     |  |     |     |
+  +  +--+  +  +--+  +  +--+--+  +--+  +  +  +
|  |     |        |  |  |     |     |     |  |
+  +--+  +--+--+  +  +  +--+  +  +  +--+--+  +
|     |        |  |  |     |  |  |        |  |
+--+  +--+--+  +  +--+--+  +  +--+--+  +  +  +
|  |  |        |        |  |        |  |     |
+  +  +  +--+--+--+--+  +  +--+--+  +--+--+--+
|     |     |        |           |           |
+  +--+--+  +  +--+  +  +--+--+--+--+--+--+  +
|  |  |     |     |  |  |           |        |
+  +  +  +--+--+  +  +--+  +--+--+  +  +--+--+
|     |           |              |           |
+--+--+--+--+--+--+--+--+--+--+--+--+--+--+--+

