+--+--+--+--+--+--+--+--+--+--+--+--+--+--+--+
|     |                 |     |           |  |
+  +  +  +--+--+--+  +--+  +  +  +  +--+  +  +
|  |     |           |     |     |     |  |  |
+  +--+--+  +--+  +--+  +--+--+--+--+  +  +  +
|  |        |     |     |        |     |     |
+  +  +--+--+--+--+  +--+  +--+  +  +--+--+  +
|  |        |        |  |     |  |  |  |     |
+  +--+--+  +  +--+--+  +  +  +--+  +  +  +--+
|  |  |     |  |        |  |  |     |  |     |
+  +  +  +--+  +--+  +--+  +  +  +--+  +--+  +
|     |           |        |  |  |        |  |
+--+  +--+--+--+  +--+--+--+  +  +--+  +  +  +
|     |        |           |  |     |  |     |
+  +--+  +--+  +--+--+--+  +  +--+  +--+  +--+
|     |  |     |        |        |     |  |  |
+--+  +  +  +--+  +--+  +--+--+--+--+  +  +  +
|     |  |     |     |                 |     |
+  +--+  +--+  +  +  +--+--+--+--+--+--+--+  +
|  |     |     |  |           |  |           |
+  +  +--+  +--+  +--+--+--+  +  +  +--+--+--+
|  |     |     |  |           |              |
+  +--+  +--+  +--+  +--+--+--+  +--+--+--+  +
|     |  |     |     |           |        |  |
+  +--+  +  +--+  +--+--+--+--+--+  +--+  +  +
|  |     |        |                    |  |  |
+--+  +--+--+--+--+  +--+--+--+--+--+--+  +  +
|     |              |     |     |     |  |  |
+  +--+  +--+--+--+--+  +  +--+  +  +  +  +  +
|                       |     |     |     |  |
+--+--+--+--+--+--+--+--+--+--+--+--+--+--+--+

